111111111111111
1PC0C0X0C000E01
10X000C0X0C0001
10C00000C00C001
1X0000X00C0X001
10C000X00C00001
10C0X00C00C00X1
10X000C000X0001
10C00X0C0000001
111111111111111