111111111111111111
100000000000000001
100111100011110001
1P001C0000000E0001
100001111110001001
1000C0000000C00101
100111111111110001
100000000000000001
111111111111111111